/* Qwerty
 * ,-----------------------------------------------------------------------------------.
 * | Tab  |   Q  |   W  |   E  |   R  |   T  |   Y  |   U  |   I  |   O  |   P  | Bksp |
 * |------+------+------+------+------+------+------+------+------+------+------+------|
 * | Esc  |   A  |   S  |   D  |   F  |   G  |   H  |   J  |   K  |   L  |   ;  |  "   |
 * |------+------+------+------+------+------+------+------+------+------+------+------|
 * | Shift|   Z  |   X  |   C  |   V  |   B  |   N  |   M  |   ,  |   .  |   /  |Enter |
 * |------+------+------+------+------+------+------+------+------+------+------+------|
 * | Brite| Ctrl | Alt  | GUI  |Lower |    Space    |Raise | Left | Down |  Up  |Right |
 * `-----------------------------------------------------------------------------------'
 */

/* Blank
 * ,-----------------------------------------------------------------------.
 * |     |     |     |     |     |     |     |     |     |     |     |     |
 * |-----+-----+-----+-----+-----+-----+-----+-----+-----+-----+-----+-----|
 * |     |     |     |     |     |     |     |     |     |     |     |     |
 * |-----+-----+-----+-----+-----+-----+-----+-----+-----+-----+-----+-----|
 * |     |     |     |     |     |     |     |     |     |     |     |     |
 * |-----+-----+-----+-----+-----+-----+-----+-----+-----+-----+-----+-----|
 * |     |     |     |     |     |     |     |     |     |     |     |     |
 * `-----------------------------------------------------------------------'
 */

 /* Blank
 * ,-----------------------------------------------------------------------------------.
 * |      |      |      |      |      |      |      |      |      |      |      |      |
 * |------+------+------+------+------+------+------+------+------+------+------+------|
 * |      |      |      |      |      |      |      |      |      |      |      |      |
 * |------+------+------+------+------+------+------+------+------+------+------+------|
 * |      |      |      |      |      |      |      |      |      |      |      |      |
 * |------+------+------+------+------+------+------+------+------+------+------+------|
 * |      |      |      |      |      |      |      |      |      |      |      |      |
 * `-----------------------------------------------------------------------------------'
 */

 /* Blank
 * ,-----------------------------------------------------------------------------------.
 * |      |      |      |      |      |      |      |      |      |      |      |      |
 * |------+------+------+------+------+------+------+------+------+------+------+------|
 * |      |      |      |      |      |      |      |      |      |      |      |      |
 * |------+------+------+------+------+------+------+------+------+------+------+------|
 * |      |      |      |      |      |      |      |      |      |      |      |      |
 * |------+------+------+------+------+------+------+------+------+------+------+------|
 * |      |      |      |      |      |      |      |      |      |      |      |      |
 * `-----------------------------------------------------------------------------------'
 */

 /* Blank
 * ,-----------------------------------------------------------------------------------.
 * |      |      |      |      |      |      |      |      |      |      |      |      |
 * |------+------+------+------+------+------+------+------+------+------+------+------|
 * |      |      |      |      |      |      |      |      |      |      |      |      |
 * |------+------+------+------+------+------+------+------+------+------+------+------|
 * |      |      |      |      |      |      |      |      |      |      |      |      |
 * |------+------+------+------+------+------+------+------+------+------+------+------|
 * |      |      |      |      |      |      |      |      |      |      |      |      |
 * `-----------------------------------------------------------------------------------'
 */

 /* Blank
 * ,-----------------------------------------------------------------------------------.
 * |      |      |      |      |      |      |      |      |      |      |      |      |
 * |------+------+------+------+------+------+------+------+------+------+------+------|
 * |      |      |      |      |      |      |      |      |      |      |      |      |
 * |------+------+------+------+------+------+------+------+------+------+------+------|
 * |      |      |      |      |      |      |      |      |      |      |      |      |
 * |------+------+------+------+------+------+------+------+------+------+------+------|
 * |      |      |      |      |      |      |      |      |      |      |      |      |
 * `-----------------------------------------------------------------------------------'
 */

 /* Blank
 * ,-----------------------------------------------------------------------------------.
 * |      |      |      |      |      |      |      |      |      |      |      |      |
 * |------+------+------+------+------+------+------+------+------+------+------+------|
 * |      |      |      |      |      |      |      |      |      |      |      |      |
 * |------+------+------+------+------+------+------+------+------+------+------+------|
 * |      |      |      |      |      |      |      |      |      |      |      |      |
 * |------+------+------+------+------+------+------+------+------+------+------+------|
 * |      |      |      |      |      |      |      |      |      |      |      |      |
 * `-----------------------------------------------------------------------------------'
 */